111111111111111111111111
1000000P0000000000000001
1001000000000000C0000001
111111111111111111111111
