111111111111111111111111
1000000P0000000000000001
100E000000000000C0000001
111111111111111111111111
