1111111111111
1000000000001
1000P00000011
1000111000001
1000111E00011
1000111000011
100C000000001
1111111111111
