1111111111
100010C001
1000111001
1P00000001
1000000001
100C000001
1000000001
100000C001
10000000E1
1111111111
